111111111111111
1C010C00000C001
100001111100001
1P0C11E00000001
1C010C00000C001
111111111111111
