1111111111111111111111
1000000000000000000001
1P10000000000000000001
1110001000000000000001
1C10J01000000000000001
1E00001000000000000001
1111111111111111111111
