1111111111111111111
1C010C00000C0000001
1100011111000000001
1P1011E000000000001
1C000C00000C0000001
1C010C00000C0000001
1C010C00000C0000001
1C010C00000C0000001
1111111111111111111
