1111111111111
100100000C001
1101011111001
1110011111C01
1P0011CE000C1
1111111111111